##############################
#   E						 #
#							 #
#							 #
#						     #
#							 #
#	p						 #
#							 #
#							 #
##############################