#################
#P..............#
#...............#
#...............#
#...............#
#....E..........#
#...............#
#...............#
#...............#
#...............#
#...............#
#...............#
#...............#
#...............#
#################